############################################### ##
########                                         #
##################################### ############
##################################### ############
#                                                #
######## #########################################
######## #########################################
#                                                #
######## #########################################
######## #########################################
######## #########################################
########                                         #
########## #### ######## ########## ##############
#      ### #### ##    ## ########## ##############
###### ### #### ## ## ## ########## ##############
###### ### #### ##### ## ########## ##############
###### ###  ###       ## ###        ##############
###### #### ######################################
######                   #########################
########### ######################################